11111111111111111111111111111111111111
1P000000010000000000000000000000000001
10000000010000000000111111111111000001
10000000010000000000000000000000000001
10000000000000000000000CCCCCCC00000001
10000000111001011110000000111111111111
10000000000000000010000000000000000001
1000CCCCCCC00000001000000CCCCCC0000001
1E000000000000000010000000000000000001
11111111111111111111111111111111111111