111111110001
1P0000000001
1000CCC00001
10000001C001
1000C001C001
1000C001C001
1000C001E001
111111111111
