111111111111111111111
100000000000000000001
10P011111111110000001
100000CCCCCCCC0010001
100011111111111010001
100000000000001C10001
100111111111001C10001
1000CCCCC0C0001C10001
100111111111001C10001
1000000000000000000E1
111111111111111111111